/------------------------\
{************************}
{************************}
{************************}
(________________________)